     ^ % % ~ ~
    ^ ^ % % ~ %
   % % % % % % %
  % % % % ^ ^ % %
 % % ^ ^ ^ ^ % % %
  % ^ % ^ ~ % % %
   % % % ~ ~ % %
    % % ~ ~ % %
     % % ~ ~ %
